mayest	may:est-*	48
wouldest	would:est-*	16
knowest	know:est-*	15
mightest	might:est-*	12
sayest	say:est-*	11
biddest	command:est-*	11
shouldest	should:est-*	10
speakest	speak:est-*	9
sleepest	sleep:est-*	5
liest	lie:est-e	5
comest	come:est-e	1
carest	care:est-e	5
slayest	kill:est-*	4
rulest	rule:est-e	4
knewest	knew:est-*	1
lovest	love:est-e	4
hearest	hear:est-*	4
bearest	bear:est-*	4
workest	work:est-*	3
thoughtest	thought:est-*	3
goest	go:est-*	3
givest	give:est-e	3
fleest	flee:est-e	3
Seest	See:est-e	3
tookest	took:est-*	2
stoodest	stood:est-*	2
slewest	slew:est-*	2
seest	see:est-e	2
seekest	seek:est-*	2
rememberest	remember:est-*	2
ragest	rage:est-e	2
pitiest	pity:est-y	2
needest	need:est-*	2
matchest	match:est-*	2
leavest	leave:est-e	2
inquirest	inquire:est-e	2
holdest	hold:est-*	2
gavest	gave:est-e	2
forgettest	forget:est-*	2
fallest	fall:est-*	2
excellest	excell:est-*	2
dwellest	dwell:est-*	2
askest	ask:est-*	2
abidest	abide:est-e	2
Knowest	Know:est-*	2
wentest	went:est-*	1
weepest	weep:est-*	1
urgest	urge:est-e	1
trustest	trust:est-*	1
sufferest	suffer:est-*	1
standest	stand:est-*	1
slumberest	slumber:est-*	1
sittest	sit:est-*	1
showest	show:est-*	1
settest	set:est-*	1
sendest	send:est-*	1
seemest	seem:est-*	1
saidest	said:est-*	1
quaffest	quaff:est-*	1
ponderest	ponder:est-*	1
payest	pay:est-*	1
offerest	offer:est-*	1
meanest	mean:est-*	1
makest	make:est-e	1
madest	made:est-e	1
layest	lay:est-*	1
lamentest	lament:est-*	1
keepest	keep:est-*	1
hopest	hope:est-e	1
gazest	gaze:est-e	1
forsakest	forsake:est-e	1
fleddest	fled:est-*	1
fightest	fight:est-*	1
exultest	exult:est-*	1
enquirest	enquire:est-e	1
drawest	draw:est-*	1
doest	do:est-*	1
desirest	desire:est-e	1
deemest	deem:est-*	1
declarest	declare:est-e	1
darest	dare:est-e	1
cowerest	cower:est-*	1
ceasest	cease:est-e	1
camest	came:est-e	1
broughtest	brought:est-*	1
bringest	bring:est-*	1
boastest	boast:est-*	1
beholdest	behold:est-*	1
beguilest	beguile:est-e	1
Wouldest	Would:est-*	1
Seekest	Seek:est-*	1
Rememberest	Remember:est-*	1
Hearest	Hear:est-*	1
Deemest	Deem:est-*	1
Canst	Can:est-*	1
canst	can:est-*	1
