Sufficeth	Suffices:eth-es	3
abideth	abides:eth-es	13
accepteth	accepts:eth-s	1
accomplisheth	accomplishes:eth-es	2
appeareth	appears:eth-s	7
approveth	approves:eth-es	1
ariseth	arises:eth-es	8
assaileth	assails:eth-s	1
availeth	avails:eth-s	4
avoweth	avows:eth-s	3
awaiteth	awaits:eth-s	1
beareth	bears:eth-s	42
beateth	beats:eth-s	1
beholdeth	beholds:eth-s	5
behoveth	behooves:eth-es	10
belloweth	bellows:eth-s	2
bendeth	bends:eth-s	1
beseemeth	suits:vocab	24
bestirreth	bestirs:CCeth-Cs	1
biddeth	bids:CCeth-Cs	31
bindeth	binds:eth-s	1
blazeth	blazes:eth-es	1
blindeth	blinds:eth-s	2
boasteth	boasts:eth-s	2
bodeth	bodes:eth-es	1
boileth	boils:eth-s	1
brandisheth	brandishes:eth-es	1
breaketh	breaks:eth-s	8
bringeth	brings:eth-s	10
bristleth	bristles:eth-es	1
broodeth	broods:eth-s	1
bubbleth	bubbles:eth-es	1
buildeth	builds:eth-s	1
burgeoneth	burgeons:eth-s	1
burneth	burns:eth-s	5
calleth	calls:eth-s	4
careth	cares:eth-es	1
carrieth	carries:eth-es	1
casteth	casts:eth-s	5
catcheth	catches:eth-es	1
causeth	causes:eth-es	1
ceaseth	ceases:eth-es	3
chanceth	chances:eth-es	1
changeth	changes:eth-es	2
chargeth	charges:eth-es	1
chaseth	chases:eth-es	1
cherisheth	cherishes:eth-es	2
chideth	chides:eth-es	1
circleth	circles:eth-es	1
cleareth	clears:eth-s	1
cleaveth	cleaves:eth-es	2
clutcheth	clutches:eth-es	1
coileth	coils:eth-s	1
cometh	comes:eth-es	39
compasseth	compasses:eth-es	1
conceiveth	conceives:eth-es	1
consenteth	consents:eth-s	1
consorteth	consorts:eth-s	1
coucheth	makes his bed:vocab	1
counteth	counts:eth-s	2
courseth	courses:eth-es	2
covereth	covers:eth-s	1
coveteth	covets:eth-s	1
crasheth	crashes:eth-es	1
croucheth	crouches:eth-es	1
crusheth	crushes:eth-es	1
cutteth	cuts:CCeth-Cs	3
darteth	darts:eth-s	8
decayeth	decays:eth-s	1
declareth	declares:eth-es	6
deemeth	deems:eth-s	2
denieth	denies:eth-es	1
departeth	departs:eth-s	2
destroyeth	destroys:eth-s	1
deviseth	devises:eth-es	1
devoureth	devours:eth-s	4
discerneth	discerns:eth-s	1
diveth	dives:eth-es	2
doeth	does:eth-es	4
draggeth	drags:CCeth-Cs	3
draweth	draws:eth-s	5
driveth	drives:eth-es	19
dwelleth	dwells:eth-s	1
eateth	eats:eth-s	1
encloseth	encloses:eth-es	3
endureth	endures:eth-es	1
ensnareth	ensnares:eth-es	1
entereth	enters:eth-s	1
escapeth	escapes:eth-es	5
exulteth	exults:eth-s	5
falleth	falls:eth-s	4
fareth	fares:eth-es	4
fasteth	fasts:eth-s	1
feareth	fears:eth-s	2
feasteth	feasts:eth-s	2
fighteth	fights:eth-s	5
fitteth	fits:CCeth-Cs	1
fleeth	flees:eth-es	6
flieth	flies:eth-es	5
floateth	floats:eth-s	2
floweth	flows:eth-s	7
followeth	follows:eth-s	2
forebodeth	forebodes:eth-es	1
formeth	forms:eth-s	1
fulfilleth	fulfills:eth-s	1
gathereth	gathers:eth-s	2
gazeth	gazes:eth-es	1
getteth	gets:CCeth-Cs	3
giveth	gives:eth-es	11
glareth	glares:eth-es	1
gleameth	gleams:eth-s	1
glideth	glides:eth-es	1
glorieth	glories:eth-es	3
goeth	goes:eth-es	21
grieveth	grieves:eth-es	1
groaneth	groans:eth-s	1
groweth	grows:eth-s	3
guideth	guides:eth-es	3
halteth	halts:eth-s	1
harmeth	harms:eth-s	1
harnesseth	harnesses:eth-s	1
hateth	hates:eth-es	1
heareth	hears:eth-s	3
heaveth	heaves:eth-es	1
heedeth	heeds:eth-s	1
helpeth	helps:eth-s	1
hideth	hides:eth-es	2
hieth	hastens:vocab	1
hindereth	hinders:eth-s	1
holdeth	holds:eth-s	16
honoureth	honours:eth-s	2
hopeth	hopes:eth-es	3
hungereth	hungers:eth-s	1
hurleth	hurls:eth-s	11
inclineth	inclines:eth-es	2
increaseth	increases:eth-es	1
irketh	irks:eth-s	1
joineth	joins:eth-s	1
joyeth	joys:eth-s	2
keepeth	keeps:eth-s	8
knoweth	knows:eth-s	12
laboureth	labours:eth-s	1
lasheth	lashes:eth-es	2
layeth	lays:eth-s	6
leadeth	leads:eth-s	3
leapeth	leaps:eth-s	15
lieth	lies:eth-es	21
lighteneth	lightens:eth-s	1
lighteth	lights:eth-s	1
liveth	lives:eth-es	5
looketh	looks:eth-s	4
loveth	loves:eth-es	7
lulleth	lulls:eth-s	1
maketh	makes:eth-es	22
marreth	injures:vocab	1
mastereth	masters:eth-s	1
meeteth	meets:eth-s	1
melteth	melts:eth-s	1
meseemeth	meseems:eth-s	2
mightest	might:est-*
mingleth	mingles:eth-es	1
minisheth	diminishes:vocab	3
moveth	moves:eth-es	1
nourisheth	nourishes:eth-es	1
nurseth	nurses:eth-es	1
nurtureth	nurtures:eth-es	1
offereth	offers:eth-s	2
oozeth	oozes:eth-es	1
ordaineth	ordains:eth-s	1
out-runneth	out-runs:CCeth-Cs	1
outstrippeth	outstrips:CCeth-Cs	1
overcometh	overcomes:eth-es	1
overmastereth	overmasters:eth-s	1
overpowereth	overpowers:eth-s	1
paceth	paces:eth-es	1
panteth	pants:eth-s	1
parcheth	parches:eth-es	1
passeth	passes:eth-es	5
perisheth	perishes:eth-es	3
persisteth	persists:eth-s	1
planteth	plants:eth-s	1
possesseth	possesses:eth-s	3
poureth	pours:eth-s	4
prayeth	prays:eth-s	3
presseth	presses:eth-s	1
prevaileth	prevails:eth-s	3
profiteth	profits:eth-s	1
promiseth	promises:eth-es	2
pursueth	pursues:eth-es	1
putteth	puts:CCeth-Cs	2
quaileth	quails:eth-s	3
rageth	rages:eth-es	10
raiseth	raises:eth-es	1
rangeth	ranges:eth-es	2
raveth	raves:eth-es	1
reacheth	reaches:eth-es	5
reareth	rears:eth-s	3
recketh	cares:vocab	3
refuseth	refuses:eth-es	1
regardeth	regards:eth-s	1
rejoiceth	rejoices:eth-es	2
rendeth	rends:eth-s	1
resoundeth	resounds:eth-s	1
resteth	rests:eth-s	1
revereth	reveres:eth-es	1
riseth	rises:eth-es	2
roareth	roars:eth-s	4
robbeth	robs:CCeth-Cs	3
rolleth	rolls:eth-s	4
rotteth	rots:CCeth-Cs	2
rouseth	rouses:eth-es	4
runneth	runs:CCeth-Cs	6
rusheth	rushes:eth-es	2
saileth	sails:eth-s	1
saveth	saves:eth-es	2
sayeth	says:eth-s	1
sayest	say:est-*	1
scattereth	scatters:eth-s	3
scourgeth	scourges:eth-es	1
seemeth	seems:eth-s	19
seeth	sees:eth-es	2
seizeth	seizes:eth-es	7
sendeth	sends:eth-s	3
setteth	sets:CCeth-Cs	4
settleth	settles:eth-es	1
shaketh	shakes:eth-es	2
shapeth	shapes:eth-es	1
sheddeth	sheds:CCeth-Cs	3
shifteth	shifts:eth-s	2
shineth	shines:eth-es	1
showeth	shows:eth-s	1
shrinketh	shrinks:eth-s	1
shuddereth	shudders:eth-s	2
sinketh	sinks:eth-s	1
sinneth	sins:CCeth-Cs	1
sitteth	sits:CCeth-Cs	5
slayeth	slays:eth-s	8
sleepeth	sleeps:eth-s	4
slinketh	slinks:eth-s	1
smiteth	smites:eth-es	10
snatcheth	snatches:eth-es	1
soundeth	sounds:eth-s	1
speaketh	speaks:eth-s	1
speedeth	speeds:eth-s	3
speweth	spews:eth-s	1
spreadeth	spreads:eth-s	4
springeth	springs:eth-s	2
staineth	stains:eth-s	1
standeth	stands:eth-s	13
starteth	starts:eth-s	2
stirreth	stirs:CCeth-Cs	2
straineth	strains:eth-s	1
stretcheth	stretches:eth-es	1
streweth	strews:eth-s	1
striketh	strikes:eth-es	1
succoureth	succours:eth-s	1
suffereth	suffers:eth-s	3
summoneth	summons:eth-s	1
surpasseth	surpasses:eth-es	1
sweepeth	sweeps:eth-s	3
swelleth	swells:eth-s	2
swoopeth	swoops:eth-s	2
taketh	takes:eth-es	5
teareth	tears:eth-s	1
telleth	tells:eth-s	1
thinketh	thinks:eth-s	2
threateneth	threatens:eth-s	3
thrusteth	thrusts:eth-s	2
thundereth	thunders:eth-s	7
tilleth	tills:eth-s	1
transgresseth	transgresses:eth-s	1
trusteth	trusts:eth-s	1
turneth	turns:eth-s	3
urgeth	urges:eth-es	4
vanquisheth	vanquishes:eth-es	2
vaunteth	vaunts:eth-s	2
vexeth	vexes:eth-es	2
vouchsafeth	promises:vocab	4
waileth	wails:eth-s	1
walketh	walks:eth-s	4
wandereth	wanders:eth-s	1
wardeth	wards:eth-s	3
warreth	wars:CCeth-Cs	1
wasteth	wastes:eth-es	2
watcheth	watches:eth-es	4
waxeth	grows:vocab	5
weareth	wears:eth-s	1
weigheth	weighs:eth-s	1
welleth	wells:eth-s	1
wetteth	wets:CCeth-Cs	2
wheeleth	wheels:eth-s	7
whetteth	whets:CCeth-Cs	1
whirleth	whirls:eth-s	1
willeth	wills:eth-s	6
withdraweth	withdraws:eth-s	1
worketh	works:eth-s	11
yoketh	yokes:eth-es	1
